prezzo	nom	prijs
pagare	ver	prijs
gratuito	ver	prijs
cauzione	nom	prijs
spendere	ver	prijs
notti	nom	kam/law
notte	nom	kam/law
cambio	ver	kam
stanza	nom	kam
grande	adj	kam
pulizia	nom	hyg
bar	nom	rest
the	loa	kam/ontb/rest
check	nom	pers
centro	nom	lig
commerciale	adj	lig
raggiungere	ver	lig
fermata	loa	lig
metro	nom	lig
station	adj	lig
wifi	nom	kam/fac
pc	nom	fac
